Kathleen	Pusker
Steve	Pusker
Robert	Kenney Jr
Jessica	Kenney
Robert	Kenney Sr.
Stephanie	Pusker
Katherine	Brown
Diana	LaMondia
Natalie	Robichaud
Cody	Cobb
Patrick	Hufnagel
Angie	Hager
Emily	Hager
Caroline	Brantley
James	Brantley
Candace	Raines
Jason	Raines
Jessica	Corey
David	Alaimo
Terry	Im
Michele	Im
Taylor	Griffin
Nikki	Paxton
Anthony	Sinphay
Kaitlyn	Bouchillon
Aaron	Bouchillon
Alexis	Hilliar-Hine
Calen	Hilliar
Kristin	Riley
Brad	Riley
Frances	Wolfe-Bertling
Aaron	Wolfe-Bertling
Adam	Wolfe-Bertling
Bridget	Patel
Shil	Patel
Margaret	Myers
Ben	Myers
Reggie	Titmas
Elizabeth	Borowski
Tori	Henderson
Kim	Balogh
Andy	Balogh
Martial	Robichaud
Amy	Robichaud
Tim	Wolfe
Pete	Brulla
James	Wolfe
Linda	Wolfe
Chris	Blassingame
Natalia	Brown
David	Goodwin
David's	Guest
David	Chea
Tori	Chea
Judy	Ruhling
Jay	Ruhling
Stephen	Ruhling
Allie	Pincus
Richard	Knox
Suzanne	Knox
Katie	Eleam
Amy	Russ
Cindy	Liu
Andy	Zhang
Kelsi	Kahler
Johanna	Davis
Eric	Davis
Elizabeth	Carbone
John David	Narramore
Staci	Kehir
Russ	Kehir
Diana	Gomez
Brianna	Byerly